{s} â’½ âš½ï¸Live Sports	^^sa0
{s} â“‚ ğŸ¤¹Multi	^^sa1
{s} â“ ğŸ¤ºeXtra	^^sa2
{h} â“„ Okay	^^hb0
{h} â’¸ Cool	^^hb1
{h} â’» Fun	^^hb2
{h} â“Œ Wow	^^hb3
{s} â“ˆ Samsung	^^s0
{s} â“… Pluto	^^s1
{h} â’¾ iptv.org	^^h2
{s} â“‹ Movies Film 1	^^s3
{h} â“ Movies Film 2	^^h4
{h} â“ Movies Film 3	^^h5
{h} â“‰ Movies Film 4	^^h6
{h} * Conspiracy Truth 1	^^h7
{h} * Conspiracy Truth 2	^^h8
ğŸŒ International	^^hc^int
ğŸ‡®ğŸ‡© Indonesia	^^hc^id
ğŸ‡¹ğŸ‡­ Thailand	^^hc^th
ğŸ‡»ğŸ‡³ Vietnam	^^hc^vn
ğŸ‡µğŸ‡­ Philippines	^^hc^ph
ğŸ‡±ğŸ‡¦ Laos	^^hc^la
ğŸ‡²ğŸ‡¾ Malaysia	^^hc^my
ğŸ‡°ğŸ‡­ Cambodia	^^hc^kh
ğŸ‡¸ğŸ‡¬ Singapore	^^hc^sg
ğŸ‡§ğŸ‡³ Brunei	^^hc^bn
ğŸ‡²ğŸ‡² Myanmar (Burma)	^^hc^mm
ğŸ‡ºğŸ‡¸ United States	^^hc^us
ğŸ‡¨ğŸ‡³ China	^^hc^cn
ğŸ‡®ğŸ‡³ India	^^hc^in
ğŸ‡®ğŸ‡¹ Italy	^^hc^it
ğŸ‡¨ğŸ‡¦ Canada	^^hc^ca
ğŸ‡¦ğŸ‡· Argentina	^^hc^ar
ğŸ‡ªğŸ‡¸ Spain	^^hc^es
ğŸ‡§ğŸ‡· Brazil	^^hc^br
ğŸ‡«ğŸ‡· France	^^hc^fr
ğŸ‡²ğŸ‡½ Mexico	^^hc^mx
ğŸ‡·ğŸ‡º Russia	^^hc^ru
ğŸ‡¨ğŸ‡± Chile	^^hc^cl
ğŸ‡©ğŸ‡ª Germany	^^hc^de
ğŸ‡©ğŸ‡´ Dominican Republic	^^hc^do
ğŸ‡¹ğŸ‡· Turkey	^^hc^tr
ğŸ‡µğŸ‡ª Peru	^^hc^pe
ğŸ‡³ğŸ‡± Netherlands	^^hc^nl
ğŸ‡¨ğŸ‡´ Colombia	^^hc^co
ğŸ‡¬ğŸ‡§ United Kingdom	^^hc^uk
ğŸ‡¬ğŸ‡¹ Guatemala	^^hc^gt
ğŸ‡­ğŸ‡³ Honduras	^^hc^hn
ğŸ‡ªğŸ‡¨ Ecuador	^^hc^ec
ğŸ‡¨ğŸ‡· Costa Rica	^^hc^cr
ğŸ‡»ğŸ‡ª Venezuela	^^hc^ve
ğŸ‡µğŸ‡¾ Paraguay	^^hc^py
ğŸ‡§ğŸ‡´ Bolivia	^^hc^bo
ğŸ‡¬ğŸ‡· Greece	^^hc^gr
ğŸ‡·ğŸ‡´ Romania	^^hc^ro
ğŸ‡­ğŸ‡º Hungary	^^hc^hu
ğŸ‡µğŸ‡· Puerto Rico	^^hc^pr
ğŸ‡°ğŸ‡· South Korea	^^hc^kr
ğŸ‡¸ğŸ‡» El Salvador	^^hc^sv
ğŸ‡¯ğŸ‡µ Japan	^^hc^jp
ğŸ‡®ğŸ‡¶ Iraq	^^hc^iq
ğŸ‡ºğŸ‡¦ Ukraine	^^hc^ua
ğŸ‡®ğŸ‡· Iran	^^hc^ir
ğŸ‡µğŸ‡¦ Panama	^^hc^pa
ğŸ‡³ğŸ‡® Nicaragua	^^hc^ni
ğŸ‡ºğŸ‡¾ Uruguay	^^hc^uy
ğŸ‡ªğŸ‡¬ Egypt	^^hc^eg
ğŸ‡³ğŸ‡¬ Nigeria	^^hc^ng
ğŸ‡¨ğŸ‡º Cuba	^^hc^cu
ğŸ‡¦ğŸ‡ª United Arab Emirates	^^hc^ae
ğŸ‡µğŸ‡° Pakistan	^^hc^pk
ğŸ‡µğŸ‡± Poland	^^hc^pl
ğŸ‡¹ğŸ‡¼ Taiwan	^^hc^tw
ğŸ‡°ğŸ‡ª Kenya	^^hc^ke
ğŸ‡¸ğŸ‡¦ Saudi Arabia	^^hc^sa
ğŸ‡¸ğŸ‡° Slovakia	^^hc^sk
ğŸ‡¸ğŸ‡³ Senegal	^^hc^sn
ğŸ‡¦ğŸ‡º Australia	^^hc^au
ğŸ‡²ğŸ‡¦ Morocco	^^hc^ma
ğŸ‡µğŸ‡¹ Portugal	^^hc^pt
ğŸ‡¯ğŸ‡´ Jordan	^^hc^jo
ğŸ‡±ğŸ‡¾ Libya	^^hc^ly
ğŸ‡¹ğŸ‡³ Tunisia	^^hc^tn
ğŸ‡©ğŸ‡¿ Algeria	^^hc^dz
ğŸ‡±ğŸ‡§ Lebanon	^^hc^lb
ğŸ‡¨ğŸ‡­ Switzerland	^^hc^ch
ğŸ‡§ğŸ‡ª Belgium	^^hc^be
ğŸ‡µğŸ‡¸ Palestine	^^hc^ps
ğŸ‡¸ğŸ‡´ Somalia	^^hc^so
ğŸ‡ºğŸ‡¬ Uganda	^^hc^ug
ğŸ‡¨ğŸ‡© Democratic Republic of the Congo	^^hc^cd
ğŸ‡°ğŸ‡¿ Kazakhstan	^^hc^kz
ğŸ‡¸ğŸ‡© Sudan	^^hc^sd
ğŸ‡¨ğŸ‡¿ Czech Republic	^^hc^cz
ğŸ‡­ğŸ‡¹ Haiti	^^hc^ht
ğŸ‡¦ğŸ‡¹ Austria	^^hc^at
ğŸ‡¿ğŸ‡¦ South Africa	^^hc^za
ğŸ‡¨ğŸ‡² Cameroon	^^hc^cm
ğŸ‡©ğŸ‡¯ Djibouti	^^hc^dj
ğŸ‡«ğŸ‡® Finland	^^hc^fi
ğŸ‡²ğŸ‡· Mauritania	^^hc^mr
ğŸ‡¨ğŸ‡® Ivory Coast	^^hc^ci
ğŸ‡°ğŸ‡² Comoros	^^hc^km
ğŸ‡·ğŸ‡¸ Serbia	^^hc^rs
ğŸ‡°ğŸ‡¼ Kuwait	^^hc^kw
ğŸ‡¸ğŸ‡¾ Syria	^^hc^sy
ğŸ‡§ğŸ‡¬ Bulgaria	^^hc^bg
ğŸ‡²ğŸ‡° North Macedonia	^^hc^mk
ğŸ‡¨ğŸ‡¾ Cyprus	^^hc^cy
ğŸ‡¦ğŸ‡¿ Azerbaijan	^^hc^az
ğŸ‡¸ğŸ‡ª Sweden	^^hc^se
ğŸ‡¾ğŸ‡ª Yemen	^^hc^ye
ğŸ‡¬ğŸ‡­ Ghana	^^hc^gh
ğŸ‡¦ğŸ‡² Armenia	^^hc^am
ğŸ‡´ğŸ‡² Oman	^^hc^om
ğŸ‡©ğŸ‡° Denmark	^^hc^dk
ğŸ‡¶ğŸ‡¦ Qatar	^^hc^qa
ğŸ‡¦ğŸ‡« Afghanistan	^^hc^af
ğŸ‡§ğŸ‡­ Bahrain	^^hc^bh
ğŸ‡­ğŸ‡· Croatia	^^hc^hr
ğŸ‡²ğŸ‡¹ Malta	^^hc^mt
ğŸ‡¸ğŸ‡® Slovenia	^^hc^si
ğŸ‡§ğŸ‡¾ Belarus	^^hc^by
ğŸ‡±ğŸ‡» Latvia	^^hc^lv
ğŸ‡²ğŸ‡© Moldova	^^hc^md
ğŸ‡ºğŸ‡¿ Uzbekistan	^^hc^uz
ğŸ‡§ğŸ‡¯ Benin	^^hc^bj
ğŸ‡±ğŸ‡º Luxembourg	^^hc^lu
ğŸ‡ªğŸ‡ª Estonia	^^hc^ee
ğŸ‡¹ğŸ‡¯ Tajikistan	^^hc^tj
ğŸ‡¹ğŸ‡¬ Togo	^^hc^tg
ğŸ‡§ğŸ‡¦ Bosnia and Herzegovina	^^hc^ba
ğŸ‡¨ğŸ‡¬ Republic of the Congo	^^hc^cg
ğŸ‡·ğŸ‡¼ Rwanda	^^hc^rw
ğŸ‡¹ğŸ‡¿ Tanzania	^^hc^tz
ğŸ‡¦ğŸ‡± Albania	^^hc^al
ğŸ‡ªğŸ‡¹ Ethiopia	^^hc^et
ğŸ‡¬ğŸ‡³ Guinea	^^hc^gn
ğŸ‡²ğŸ‡³ Mongolia	^^hc^mn
ğŸ‡³ğŸ‡µ Nepal	^^hc^np
ğŸ‡³ğŸ‡¿ New Zealand	^^hc^nz
ğŸ‡¬ğŸ‡µ Guadeloupe	^^hc^gp
ğŸ‡®ğŸ‡ª Ireland	^^hc^ie
ğŸ‡±ğŸ‡° Sri Lanka	^^hc^lk
ğŸ‡§ğŸ‡« Burkina Faso	^^hc^bf
ğŸ‡¬ğŸ‡¦ Gabon	^^hc^ga
ğŸ‡²ğŸ‡± Mali	^^hc^ml
ğŸ‡§ğŸ‡© Bangladesh	^^hc^bd
ğŸ‡¨ğŸ‡» Cape Verde	^^hc^cv
ğŸ‡¬ğŸ‡¶ Equatorial Guinea	^^hc^gq
ğŸ‡®ğŸ‡± Israel	^^hc^il
ğŸ‡°ğŸ‡¬ Kyrgyzstan	^^hc^kg
ğŸ‡±ğŸ‡¹ Lithuania	^^hc^lt
ğŸ‡²ğŸ‡¶ Martinique	^^hc^mq
ğŸ‡²ğŸ‡¿ Mozambique	^^hc^mz
ğŸ‡ªğŸ‡­ Western Sahara	^^hc^eh
ğŸ‡¦ğŸ‡´ Angola	^^hc^ao
ğŸ‡½ğŸ‡° Kosovo	^^hc^xk
ğŸ‡²ğŸ‡¼ Malawi	^^hc^mw
ğŸ‡§ğŸ‡± Saint BarthÃ©lemy	^^hc^bl
ğŸ‡²ğŸ‡« Saint Martin	^^hc^mf
ğŸ‡¿ğŸ‡¼ Zimbabwe	^^hc^zw
ğŸ‡¬ğŸ‡² Gambia	^^hc^gm
ğŸ‡¬ğŸ‡ª Georgia	^^hc^ge
ğŸ‡²ğŸ‡¬ Madagascar	^^hc^mg
ğŸ‡³ğŸ‡ª Niger	^^hc^ne
ğŸ‡³ğŸ‡´ Norway	^^hc^no
ğŸ‡¸ğŸ‡± Sierra Leone	^^hc^sl
ğŸ‡¦ğŸ‡¼ Aruba	^^hc^aw
ğŸ‡§ğŸ‡¼ Botswana	^^hc^bw
ğŸ‡§ğŸ‡® Burundi	^^hc^bi
ğŸ‡¹ğŸ‡© Chad	^^hc^td
ğŸ‡±ğŸ‡· Liberia	^^hc^lr
ğŸ‡²ğŸ‡º Mauritius	^^hc^mu
ğŸ‡¾ğŸ‡¹ Mayotte	^^hc^yt
ğŸ‡³ğŸ‡¦ Namibia	^^hc^na
ğŸ‡·ğŸ‡ª RÃ©union	^^hc^re
ğŸ‡¸ğŸ‡¹ SÃ£o TomÃ© and PrÃ­ncipe	^^hc^st
ğŸ‡¸ğŸ‡¿ Swaziland	^^hc^sz
ğŸ‡¿ğŸ‡² Zambia	^^hc^zm
ğŸ‡¨ğŸ‡« Central African Republic	^^hc^cf
ğŸ‡¨ğŸ‡¼ Curacao	^^hc^cw
ğŸ‡¹ğŸ‡± East Timor	^^hc^tl
ğŸ‡ªğŸ‡· Eritrea	^^hc^er
ğŸ‡¹ğŸ‡« French Southern Territories	^^hc^tf
ğŸ‡¬ğŸ‡¼ Guinea-Bissau	^^hc^gw
ğŸ‡¯ğŸ‡² Jamaica	^^hc^jm
ğŸ‡±ğŸ‡¸ Lesotho	^^hc^ls
ğŸ‡¸ğŸ‡­ Saint Helena	^^hc^sh
ğŸ‡¸ğŸ‡¨ Seychelles	^^hc^sc
ğŸ‡¸ğŸ‡¸ South Sudan	^^hc^ss
ğŸ‡¬ğŸ‡« French Guiana	^^hc^gf
ğŸ‡²ğŸ‡ª Montenegro	^^hc^me
ğŸ‡¦ğŸ‡© Andorra	^^hc^ad
ğŸ‡¸ğŸ‡½ Sint Maarten	^^hc^sx
ğŸ‡¹ğŸ‡² Turkmenistan	^^hc^tm
ğŸ‡»ğŸ‡¦ Vatican City	^^hc^va
ğŸ‡¬ğŸ‡¾ Guyana	^^hc^gy
ğŸ‡²ğŸ‡» Maldives	^^hc^mv
ğŸ‡¹ğŸ‡¹ Trinidad and Tobago	^^hc^tt
ğŸ‡¦ğŸ‡¬ Antigua and Barbuda	^^hc^ag
ğŸ‡§ğŸ‡¸ Bahamas	^^hc^bs
ğŸ‡±ğŸ‡¨ Saint Lucia	^^hc^lc
ğŸ‡§ğŸ‡§ Barbados	^^hc^bb
ğŸ‡»ğŸ‡¬ British Virgin Islands	^^hc^vg
ğŸ‡©ğŸ‡² Dominica	^^hc^dm
ğŸ‡®ğŸ‡¸ Iceland	^^hc^is
ğŸ‡°ğŸ‡³ Saint Kitts and Nevis	^^hc^kn
ğŸ‡¦ğŸ‡® Anguilla	^^hc^ai
ğŸ‡§ğŸ‡¿ Belize	^^hc^bz
ğŸ‡°ğŸ‡¾ Cayman Islands	^^hc^ky
ğŸ‡¬ğŸ‡© Grenada	^^hc^gd
ğŸ‡±ğŸ‡® Liechtenstein	^^hc^li
ğŸ‡²ğŸ‡¨ Monaco	^^hc^mc
ğŸ‡²ğŸ‡¸ Montserrat	^^hc^ms
ğŸ‡»ğŸ‡¨ Saint Vincent and the Grenadines	^^hc^vc
ğŸ‡¹ğŸ‡¨ Turks and Caicos Islands	^^hc^tc
ğŸ‡»ğŸ‡® U.S. Virgin Islands	^^hc^vi
ğŸ‡­ğŸ‡° Hong Kong	^^hc^hk
ğŸ‡¸ğŸ‡² San Marino	^^hc^sm
ğŸ‡§ğŸ‡¹ Bhutan	^^hc^bt
ğŸ‡¬ğŸ‡± Greenland	^^hc^gl
ğŸ‡°ğŸ‡µ North Korea	^^hc^kp
ğŸ‡§ğŸ‡² Bermuda	^^hc^bm
ğŸ‡¬ğŸ‡º Guam	^^hc^gu
ğŸ‡²ğŸ‡´ Macao	^^hc^mo
ğŸ‡«ğŸ‡² Micronesia	^^hc^fm
ğŸ‡µğŸ‡² Saint Pierre and Miquelon	^^hc^pm
ğŸ‡¼ğŸ‡¸ Samoa	^^hc^ws
ğŸ‡«ğŸ‡¯ Fiji	^^hc^fj
ğŸ‡µğŸ‡« French Polynesia	^^hc^pf
ğŸ‡¦ğŸ‡¸ American Samoa	^^hc^as
ğŸ‡¨ğŸ‡° Cook Islands	^^hc^ck
ğŸ‡°ğŸ‡® Kiribati	^^hc^ki
ğŸ‡²ğŸ‡­ Marshall Islands	^^hc^mh
ğŸ‡³ğŸ‡· Nauru	^^hc^nr
ğŸ‡³ğŸ‡¨ New Caledonia	^^hc^nc
ğŸ‡³ğŸ‡º Niue	^^hc^nu
ğŸ‡³ğŸ‡« Norfolk Island	^^hc^nf
ğŸ‡²ğŸ‡µ Northern Mariana Islands	^^hc^mp
ğŸ‡µğŸ‡¼ Palau	^^hc^pw
ğŸ‡µğŸ‡¬ Papua New Guinea	^^hc^pg
ğŸ‡µğŸ‡³ Pitcairn Islands	^^hc^pn
ğŸ‡¸ğŸ‡§ Solomon Islands	^^hc^sb
ğŸ‡¸ğŸ‡· Suriname	^^hc^sr
ğŸ‡¹ğŸ‡° Tokelau	^^hc^tk
ğŸ‡¹ğŸ‡´ Tonga	^^hc^to
ğŸ‡¹ğŸ‡» Tuvalu	^^hc^tv
ğŸ‡»ğŸ‡º Vanuatu	^^hc^vu
ğŸ‡¼ğŸ‡« Wallis and Futuna	^^hc^wf
ğŸ‡§ğŸ‡» Bouvet Island	^^hc^bv
ğŸ‡«ğŸ‡° Falkland Islands	^^hc^fk
ğŸ‡¬ğŸ‡¸ South Georgia and the South Sandwich Islands	^^hc^gs
ğŸ‡§ğŸ‡¶ Bonaire	^^hc^bq
ğŸ‡«ğŸ‡´ Faroe Islands	^^hc^fo
ğŸ‡¬ğŸ‡¬ Guernsey	^^hc^gg
